################################################################################ ###############################################################################
     #                   #       #             #             #       #                       #       #     #   #                   #     #   #     #     #     #
 ##### # ############### ### ### ####### # # ### ##### ####### # # ### ####### ### ######### ### ### # # # # # # ####### ######### ### # # ### ### # # ### # # #
 #   # # #       #     #     #   #     # # # #   #   #         # # #   #     # # # #   #   #     #   # # # # #         #         #   # # #     #   # #     # # #
 # # # # ### ### # # ######### ### ### ### # # ### # ########### # # ### ### # # # ### # # ####### ### # # # ######### ######### ### # # # ##### ### ####### ###
 # #   #   #   # # #     #   #     # # #   # #     # #         # # # #   #   #   #   # # #       #   # # # # #   #   #       #   #     # #     #   #       #   #
 # ####### ### # # ### # # ######### # # ### ####### # ##### # # ### # ##### ####### # # # ####### ### # # # ### # # ####### # ######### ##### ### ####### ### #
 #       # # # # # #   #   #         #   #   #   #   # #   # # #     #     #         #   #         #   # # # #   # # # #     #     #     #   #   #       #   # #
 ### ##### # # # # # ### ### ##### # ##### ##### # ### # ### # ########### # ############# ######### ### ### # ### # # # ######### ### ### ##### ##### ### ### #
 #   #     #   #   # #   #   #   # #     # #     # #   # #   #     #   #   # #   #       #         #   #   #   #   # #     #     #   # #   #     #   #     #   #
 # ### ##### ####### # ### ### # # ####### # # ### # ### # ####### # # # # ### # # ##### ####### ##### ### # ### ### ##### # ### ### # ### # ##### # ####### # #
     #     #       # #   #   # # #     #   # # #   #     # #       # # # # #   # # #   # #   #   #     #   # #   # #   # # #   #     #   # #       #   #     # #
########## ######### ####### # # ##### # ### ### ### ##### # ####### # # ### ### # # # # # # ##### ##### ### # ### ### # # ### ######### # ########### # ##### #
           #         #     # # # #   #   #   #   #   #     # #   #   # # #   # #   # # # # # #     #   # #   #   #   # #   # #     #     #           # #   # # #
 ########### ### ##### ### # # # # ######### # ####### ##### # # # ##### # ### ##### ### # # # ##### # # # ##### ### # # ### ##### ##### ##### ####### ### # # #
           #   # #     #   # # # #       #   #       #   #     #   #   # # #       #   #   #     # # # #   #   #   # # #     #   #     #     #         # # #   #
########## ### ### ##### # # # # ### ### # # ####### # # ######### # # # # # ### # ### ######### # # # ##### # ### # # ##### # # ##### ##### # ######### # # ###
       #   #   #   # #   # # # #     #     # #     # # #     #     # # # # #   # # #     #     #   # #       # #   #   #   # # # #     # #   # #   #     # # # #
 ##### # ### ### ### # ### # # # ####### ##### ### # ### ### # ##### # # # ##### # # ##### ### ##### ######### # ### ##### # ### # ##### # ### # # # ### # # # #
   #     #   #   #   #   # #   # #     # #     #   #   # #   # # #   # #   #     #   #   # #   #     #     # #   #   #     # #   # # #     # # # # #   # # #   #
 # ######### # ### # ### ####### # ### ### ##### # ### # # ### # # ### ### # # ####### # # # ### ##### ### # ##### ### # ### # ### # # ##### # # # ### # # ### #
 #         # #   # #   #     #   #   #     #   # #   # # # # # # # # #   #   # #       #   # #   #     # #   #     #   #       #   #     #       #     # #   # #
 ######### # ### # ####### ### ##### ####### ### ### # ### # # # # # ### ####### ########### # ### ##### # ### ####### ######### ####### ############### ### ###
 #       # #     #       # #   #   #   #   #   # #   #     # # # # #     #     # #   # #       #   #       #   #     #     #   #       #       #           #   #
 # # ### # # ######### # # # ### # ### # # # # # # ######### # # # ### ### ### # # # # # ####### ### ##### # ### # # ####### # # ##### ####### ########### ### #
 # # #   # # #       # # #   #   # # # # # # # # # #         # # #   #   # # # #   # #   #     #   # #   # # #   # #         # # #   #       # #       # # # # #
 # # # ### # ##### # # # ####### # # # # ### # # ### ##### ### # ### ### # # # # ### # ### ### # # ### # # # ##### ########### ### # ##### # # # ##### # # # # #
 # # #   # #       # # #         #   # #     # #   #   #   #       # #     # # #   # #   # # # # #     # # #       #     #   #     #     # # #   # #   #     # #
 ### ### # ######### ### ####### ##### # ##### ### ### # ### ####### # ##### # ##### ##### # # ### ##### # ######### ### # # ########### ### ##### # ######### #
     # # # #     # #   #   # #   #     #   #   #     # #     # #     # #   #         #     # #   #   #   #     #     # #   #                 #   #   #     #   #
###### # # # ### # ### # # # # ### ######### ### ##### ####### # ####### # ####### ### ##### ### ### # # ##### # ##### ####################### # # ### ### # ###
     #   #     # #     # # # #   #       #   #   #     #       #   #     #   #   # #   #       # #   # # #   # #       #       #         #   # # # #   # # #   #
 ##### ######### # ##### # # ### ####### # # # ### ####### ### ### # ####### # # ### ### # ##### # ### ### # # # ####### ##### # ####### # ### # # # ### # ### #
     # # #       #     # # #       #     # # #   #       # #     # # #     #   #     #   #     # #   #     # # # #   #   #   #     #     #   # #     #       # #
#### # # # ########### # # # ####### ##### # ### ####### # ##### # # # ### ################### # ### ####### ### # # # ### ######### ####### # ############# # #
     #   #   #       # # # # #       #     # #       #   #   #   #   #   #             #       # # #   #   #     # #   #         #   #       # #   #     # # # #
 ### ### ### # ##### # # # ### ####### ##### # ####### ##### # ####### ########### ### # ### ### # ### # # ####### ########### # # ### ####### # # # ### # # # #
   #   # # # # #   # # # #   #     #     #   #       # #     # #   #   #     #     # #   #   #   #   # # #   #   # #           # # #             # # #   #     #
## ### # # # ### # # # # ### ##### ### # ### ####### # # ##### # # ### # ### # ##### # ####### ##### # ### # # # # # # ######### # # ############### # #########
   #   # # # #   #   # # #   #   #   # #   #   #     # # #   #   #   # # #     #   # # #       #     # #   # # # # # # #   #   # # # #       #       #         #
 ### ### # # # ####### ### # ### ### # ### ##### ##### # # # ####### ### # ##### # # # # ####### ### # # # ### # # # # # # # # # # # # ##### # ############# # #
   #   #   # #   #     #   # #     # # # # #   #       #   #   #     #   # #     # #   #   #   # #   # # # #   #     # # # # #   # # # #   # # #   #       # # #
 # ####### # ### # ##### ### # ##### # # # # # ############### # ##### ### # ##### ####### # # # ##### # ### ########### # ##### # # # # # # # # # # ##### ### #
 #       # #   #     #   # #   #     #   #   #           #   # # #     #   # #   # #       # # #         #   #   #       #     # # #   # # # #   # #   #   #   #
 ####### # ### ##### # ### ### # ####### ######### ##### # # # # # # ####### # # # # ####### # ######### # ### # # ########### ### ##### # ##### ##### # ### # #
       #   #   #   # # #   #   # #     # # #     # #     # #   # # #       #   # # #         #     #   # # #   # #   #     #     #       #     # #     #     # #
########## # ### # # # # ### ### # ##### # # ### # # ##### ##### ### ##### # ##### ############### # # ### # # ##### # ### ##### # ######### ### # ########### #
         # #     # #   #       # #       # # #     #   #   #   #   #   #   # #     #       #     #   #     # # #   #   # #   # # # #   #   # #   #       # #   #
 ####### ######### ##### ####### # ####### # ######### # ### ##### ### # ### # ##### # ### # ################# # # ##### ### # # ### # # # # # ######### # # ###
     # #   #       #   #   #   # # #       #   # #   # # # #     # #   # #   #   #   #   # #       # #         # #     # #   #       #   # #   #     #   #     #
#### # ### # ####### # # ### # # # # ######### # # # # # # # ### # # ### # ##### # ##### # ##### # # # ### # ### ### # # # ### ########### ##### ### # ####### #
     #     #         # # #   #   # #   #   #   # # # #   #   # #   #   #     #   #   # # #       # #   # # # #     # #   # # #   #     #     #   # # #       # #
 ####### ############# # # ####### ### # # # ### # # ##### ### ##### ####### # ##### # # ######### # ### # ### ##### ##### # ### # ### ##### # ### # ####### # #
       # #   #     #   # #     #       # #   #   # #   #   # #     # #   # # #         # #     #   #     #     #   # #     #     # # #   #     #   # #       # #
 ##### # # # # ### # ######### ####### # ##### ### ### # ### # # # ### # # # ##### ##### # ##### ### ########### # # # ##### ##### # ### ####### # # # ####### #
   #   #   # # #     #     # #       # #   #   #   # #   # #   # #     # #   #   # #     #   #   # # #       #   # # #     #     #   # # #   #   #     #   #   #
## # ####### # ####### # # # ####### ##### ### # ### ##### # ### ####### ##### # ### ##### # # ### # # ##### # ### # ##### ######### # # # # ########### # # ###
   # #         #       # #   #     #     #   #   #       #   #   #     #       #     #   # #   #     #     # # #     #   #         #   #   #       #     #   # #
 ### ######### # ####### ### ##### ##### ### # ### ##### # ### ####### ############### # # ############### # # ####### # # ####### ### ########### ##### ##### #
 # #         # # #     # #       #     #     # #   #   # # #   #       #             # #   #         #   # #   #     # # #     #     # # #   #   #     # #     #
 # ######### ### ##### # ####### ### ######### # ### ### # # ##### ### # ########### # ##### ####### # # # ##### ### # # ####### # ### # # # # # ##### # ##### #
   #     # #           #     # #   #   #     #   #     # # # #     #   #       #   #   #     #   #   # #   #   # # #   # #       # #   # # #   #     # #       #
## ### # # ######### ####### # ### # # # ### ######### # ### ### ### ######### # # ##### ##### # # ### # ### # # # ##### # ######### ### # ##### ### # ####### #
 #     # #     #   # #       # #   # #     #   #   #   #     #   # #     #   #   #   #   #   # #     # # #   # # #     # #   #       # #   #   #   # # #     # #
 ####### # ### # # ### ####### # ### ####### # # # # ######### ### ##### # ######### ### # # ####### # # # ### # # ### # ### # ####### # ### # ### # # ##### # #
     #   #   # # #   # #   #     #   #       #   #   #       #   #     # #   #     # #   # # #     #   # #   # # #   # #   #   #   #   # #   #   # # #     #   #
## ### ##### ### ### # ### # ##### ### ######### ##### ### # # # ### # # ### # ### # # ### # # ### ##### ### # # ### # ### # ### # # # # ### ##### ####### ### #
   #         #   # # # #   #     # #   #   #     #     #   # # #   # #       # # #     #   #   # #     # #   # # # # #     #   # # # # #   #     #       #   # #
 ### ######### ### # # # ####### ### ### ### ##### ##### ### # ### ########### # ##### # ####### ##### ### ### # # # ######### # ### # ### ##### ####### ### ###
     # #       # #   # #       #   #   #         # # #   #   #   #           #   #   # #       #       #   # #   # # #         #     #   #           #     #   #
 ##### # ####### # ### ### ####### # # ########### # # ### ##### ########### ### # # ######### # ####### ### ##### # # ############### ####### ####### ####### #
       # #       # # #   # #   #   # #           # # #   #   #   #         #     # #       #   # #   #     #   #     #               #       # #       #   #   #
###### # ### # ### # # # # # # # ######### ##### # # ### ##### ### ####### ####### ####### # ### # # ##### # # # ################### ##### ### # ##### # # # # #
     # #   # # #   #   # #   # # #       #     # # #   #       #     #   #   #   #   #   #   # #   #       # #   #     #   #       #     # #   #     # # #   # #
 ### # ### ### # ### ### # ### # # ##### ####### # # # ######### ##### # # # ### ### # # ##### ############# ##### ### # # # ### ####### # # ####### ### #######
   # # # #   #   #     # # # #     # #           # # #     #     # #   # # #       #   #   #       #       #     # #   # #     #       # #         #   # #     #
 # ### # ### # ######### # # ####### # ######### # ####### # ##### # ### # ####### ####### # # ### ### ### ##### # # ############### # # ####### ##### # # ### #
 #     #   # #       #   #   #     #   #   # #   #       # # #     # # #   # #     #     # # # #   #   # #   # #   #       #       # # #     #   #     #     # #
 ####### # # ####### # ### ### ### # ### # # # ######### # # ### ### # ##### # ####### # # ### # ### ### ### # ########### # ##### # ####### # ### ########### #
   #     # #     #     #   #   #   #   # # #   #       # # #   # #   # #     # #       # # #   # #   #   # # #   #   #   # # #   # # #     # #   # #   #       #
## # # ### ##### # ######### ### ### ### # ##### ##### # # ### # # ### # # # # ### # ##### # ### # ### # # # # # # # # # # # ### # # # ### # ### # # # # ##### #
   # # #     #   # #           # # # #   #   #   #     # #   #   #   #   # # #   # #     # #   # # #   #   # # # # # # #   # #   # #   #   #   # # # #   #     #
 ##### # ##### ##### ########### # # # ##### # ### ##### # ### ##### ### # ##### ####### # ### # # # # ##### # # # # # ##### # ### ##### ##### ### # ####### ###
     # #   #   #     #       #   #   # #     # # #       #     #   #   # # #   #       # # #   #   # #   #     #   # # #     #   #     #     #     #       # # #
#### # ### # ### ##### ##### # ### ### # ##### # ######### ##### # ### ### # # ####### # # # ######### # # ######### # # ##### # ##### # ### ##### ####### # # #
   # # # # #     #     #       #     # # #   #     #     # #   # #   #   # # #           # # #       # #   #     #   #   #     #     # #   #             # #   #
 ### # # # ####### # ############### # # # # ##### ##### # # # # ### ### # # ############# # # ##### ####### ### ######### ####### ### ### ##### ######### ### #
   # # # #   #   # # #   #     #   # # #   #     #     #   # # # # #     #   #   #         #   #   #         #   #       # #   # #   # #   #   # #         #   #
 # # # # ### # # # ### # # ### # # ### ##### ######### ##### # # # ####### ### ### ######### ### # ########### ### ##### # # # # ### # ##### # ### ######### ###
 #     #       # #     #     #   #         #                 #   #             #   #             #           #         #     #     #         #     #           #
