         #       #   
 ##### ### # ### ### 
   # #     #   #     
## # ######### ##### 
 #   #   #   #   #   
 ### ### # # ### ####
 #       # #   # #   
 # ####### ### # # # 
   #       #     # # 
#### # ######### # # 
     # #   #   # # # 
 ##### # # # # ### # 
 #   # # #   #   # # 
 # ### # ####### # # 
 #   # #   #   #   # 
 ### # ### ### ##### 
   #     #     #     
 # ####### ##### ####
 #         #   #     
 ########### # ##### 
         #   #       
